XXXXXXXXXX
X1  OOXOOX
XOO OOOOOX
XOOXOOXOOX
XOOOOOOOOX
XOOXOOXOOX
XOOOOO OOX
XOOXOO  2X
XXXXXXXXXX