XXXXXXXXXX
X1  OOX 3X
XOO OOOO X
XOOXOOXOOX
XOOOOOOOOX
XOOXOOXOOX
X  OOO OOX
X4 XOO  2X
XXXXXXXXXX