XXXXXXXXXXXXXXXXXXXXXXXXXXX
XXXOOOOOXOOOOOOOOOOOOOO OXX
XX 1 O XXXOOOO  OOOOO X 2 X
XOOX OOOXOOX OOOO X OOOX OX
XOOOOXOOXOOOOOOOOOOOO XOOOX
XOO XOOOOOOOX X OOO XXOOO X
X OOOOXOOOXXXOOOO XOOXOOOOX
XOO XOOOOOO XOOO OXOOXOOOOX
X  OOOOOOOXOOO XO OOOXOOOOX
XOOXOOXOXOXOXOOXOOXX O OOOX
X O OXOOXOOOOOOXOOOOOX  O X
X 4 OOXOOOOXOOOOXOOO  3   X
XXXXXXXXXXXXXXXXXXXXXXXXXXX